11111111111111111111111111111111111111111111
10C0000000000000H000000000000000000H0000E001
1000C00000000000000000000000000000000H000001
10000000000000H0000000H000000H0000000C000001
100000000000000000000000000H000000H0000C0001
10000000000000000000000000H0000000000H000001
1000000P000000000000000H000000000H000000C001
10000000000000000000000000000000000000000001
11111111111111111111111111111111111111111111
