11111111111111111111111111111
1EC00H10000000000000000110001
1101C100110111011101110111101
10001000101C10010101000000001
10100011111001010111011111101
101C1010001000001010000100101
10101000010101111111011111101
10000010101001010001000000001
10101010111111101110110111101
101010000000C000000P00000H1C1
10101011010101110111011111111
1C101010000000100000010000001
11111111111111111111111111111